equipment
cell
bin 
being 
buried 
causing 
environment.
Environmental 
recycling enough -- 7??
encouraging
Waste
instead 

zeus-----------------

 probably - веероятно

 ancienе - древний
powerful - мощьный
thunder -гром
lightning - молния
change - изменение
 pleasant - приятный
resided  - проживать
ruled - правил
kind - добрый --------------- своего рода -- ---  kind and fair ?
fair - справедливый
However -однако
temper - характкр
soon  - скоро
 punish - наказать
displeased -недовольный



silicon valey ----


located - расрпологается
Bay - залив 
large - большой
graduate -выпускник
founded - основной 
rented - арендованный
scientist - ученый
established  - признаны(утановлены) 
rent - аренда
Among - среди
well-known - изветный
engines - двигатели 
manufacturers - производители
so-called - так называемые
enterprises - предприятия
sprang up - вскочили(выросли)
including  - в том числе
 collapsed - розвалился
afford - позволять













